####S###########   ####
#  #    #      #####  #
#  ###  #####         #
#    #  #   #         #
#  ###  ### #         #
#           #         #
#         ####   ######
#    E#####