###############
  #   #   # # #
### # # ### # #
  # # #     #  
##### # ### ###
      # #   # #
##E###### ##S #
