######### ############### ######### # #
#     #   #       #       #         # #
# ### ### ### # # # # ### ##### ##### #
# #     #   # # # # # #       #     # #
### ######### # ##### ### ##### ### # #
#     #       #   #     #   #     # # #
### ### ### ### ##### ##### ###########
# #     # #   #   #     # #     #   # #
# # # ### # # # ### ### # # # ##### # #
# # # #     # #     #   # # # # #   #  
# ##### ######### ##### # ##### # # # #
#           #     #   # # #   #   #   #
# # # # # ### ####### ### ### ### #####
# # # # # # # # #   # #   #       #   #
# ####### # # # # ### ### # ### ### # #
# #       # # # # # #       # # #   #  
######### # ### # # # ####### ##### ###
#   #             # # #       # #   #  
# ##### ####### ### # ##### # # # ### #
  #   #   # #   #       # # # #   #   #
### ##### # ####### ##### # ##### #####
# #   # #     #     #   #   #   #   #  
# # # # # ######### # ##### # #########
  # # #   #     #     #   #   #   #   #
### ########### ### ### ### ##### # ###
#     # #   # # #   # #   #       #    
# ##### ### # # ### # ### ####### #####
  #     #       # #       # #       #  
### ### ### ##### ### ##### # ### # # #
    # # #           # #         # #   #
##### ####### ### # ######### # # # ###
    #   # #     # # #     #   # # # #  
##### ### # ##### ### ############# ###
    #   #       # #   #   #   #   # # #
##### ####### # # ### ### E## # ##### #
#   #   # #   # # #       # #   # # #  
### # ### # ####### ##### # # ### # ###
  #   # # #       #     #   # #   #   #
##S ### # # ############### # ### # ###
