### #######
#   #   # #
### ### E #
#       # #
##### ### #
#   # #   #
# S # ### #
  # #   #  
###########
  #       #
######### #
