####### ##### #
#   # # #     #
### # # ### # #
  #   # #   # #
### ### ######E
      # # #    
##S###### #####
