####### # # #######
# #   # # # # # #  
# # ######### # ###
#       #       #  
# ####### ### ####E
    #     #        
# # ### # ##### ###
# #   # # #   # #  
####### ##S ### ###
    #     #     # #
##### # ##### ### #
    # # #     # # #
##### # ### ### # #
#     # #       # #
### ### # ### # # #
# # #   #   # # #  
# ######### #######
    #   # #     #  
##### ### #########
