##### # ### ##E
# #   #   #   #
# # ##### # ###
  #   #   # #  
############# #
#       #     #
### S##########
